00000000000000000013
XXXXXX
X    X
X B  X
XG   X
XXXXXX
