00000000000000000000
XXXXXX
XB   X
X   BX
X #  X
X  G X
XXXXXX
